1111111111111111
1000000000000001
1000000000000001
1000000000000001
1000000000000001
1000000000000001
1000000000000001
1000001111000001
1000000000000001
1001110000111001
1000000000000001
1111111111111111